
C 100,101,20
F 91,95,144

trim  C and F and texture

9isset hyati jamila o 9iset hyatkom 3adaaaaaaaaab1

check if file are .xpm

NO ./texture/North.xpm
SO ./texture/south.xpm
EA ./texture/east.xpm
WE ./texture/west


empty line after map



multipel player print map does not have a player


                        11111111111111111
111111111111111111111111111111111111111111111111111111111
11000000110110000001100000000000000000110000000000000000011
11000110000110000001100000000000111111110000010000000000011
11000111111111000001111111100000110000000000010000000000011
10000000000000100000000011011001100111101100100000111111111                    1
11111111111111111111111111111111111111111111111111111111111
1111111111111111111111111111111111111111111111111111111111
11111111111110000000111111101110011001111110011111110000011
11000S00000010000001000000000000011001100000000000000000111
11000000000000001119iset_hyati11111001100000000011111111111
11000111111001001000110010001100000000000000100000000000011
110001000010010010011001100011000S1111111100100111111111111
11100100101001111001100110001100011001000000001000100010011
11000100100000000000000000001100000001101100100010001000111
1111111111111111111111111111111111111 11111111111111111111





