NO ./texture/North.xpm
SO ./texture/south.xpm
WE ./texture/west.xpm
EA ./texture/east.xpm
F 220,100,0
C 225,30,0
        1111111111111111111111111
        1000000000110000000000001
        1D11000001110000000000001
        1001000000000000000000001
111111111D11000001110000000000001
10000000001100000111D111111111111
1111D111111111D11100000010001
1111D111111111D111D1D10010001
1100000011D1D1D11100000010001
10000000000000001100000010001
100000000000000011D1D10010001
1100000111D1D1D11111D11110N01
1111D111 111D1D1 1D1111D10001
11111111 1111111 111111111111