NO ./texture/wall.xpm
SO ./texture/wall.xpm
EA ./texture/wall.xpm
WE ./texture/wall.xpm

F 220,100,0
C 225,30,0

        1111111111111111111111111
        1000000000110000000000001
        1010000001110000000000001
        100000N000010000000000001
111111111010000001110000000000001
100000000010000001110111111111111
11110111111111011100000010001
1111011111111111101010010001
11000000110101011100000000001
10000000000000000000000010001
10000000000000001101010010001
11000001110101011111011110001
11110111 1110101 101111010001
11111111 1111111 111111111111
