NO ./texture/wall.xpm
SO ./texture/wall.xpm
EA ./texture/wall.xpm
WE ./texture/wall.xpm

F 220,100,0
C 225,30,0

        1111111111111111111111111
        1000000000010000000000001
        1010000000010000000000001
        1000000000010000000000001
11111111100000N000010000000000001
100000000000000000010111111111111
111101110000000000010000000010001
111101111111111111111001000111111
11000000110101011100000000001
10000000000000000000000010001
10000000000000001101010010001
11000001110101011111011110001
11110111 1110101 101111010001
11111111 1111111 111111111111
